Action=Action
AddRevokeSysAdmin=Assign / Revoke SysAdmin
ADMConfig=D365FO Admin Toolkit Configuration
ADMDisableUsersJob=D365FO Admin Toolkit Execute Disable Users Job
ADMExportRoleAccess=D365FO Admin Toolkit Export Role Access
ADMMaintain=D365FO Admin Toolkit Maintain
ADMSysAdmAssignment=D365FO Admin Toolkit SysAdmin Assignment
ADMView=D365FO Admin Toolkit View
ADMViewDisabledUsersReport=D365FO Admin Toolkit View Disabled Users Report
ADMViewReport=D365FO Admin Toolkit View SysAdmin Report
Assigned=Assigned
AssignmentReason=Assignment Reason
AssingSysAdmin=Assign SysAdmin
ASTSysAdminChange=Admin Security Toolkit - SysAdmin Change
Cancel=Cancel
ChangeReason=SysAdmin Assignment Change Reason :
ConfigurationSetup=Configuration Setup
D365FOAdminToolkit=D365FO Admin Toolkit
DateTime=Date Time
DefaultNumDaysReport=Default Number of Days for Reports
DisableUserJob=Disable Users Job
DisableUserNumDays=Disable User Number of Days
EmptyReason=Value for Reason Must be Provided.
EndDate=End Date :
EnvConfigFileGenerated=Environment Configuration File Generated Successfully.
Environment=Environment
ExportRoleAccess=Export Role Access
ExportSysConfig=Export System Configuration
General=General
InquiriesReports=Inquiries and Reports
LastLogin=Last Login
ModifiedBy=Modified By
NumDaysLastLogin=Number of Days Since Last Login :
Parameters=D365FO Admin Toolkit Parameters
PeriodicTasks=Periodic Tasks
Reason=Reason
Revoked=Revoked
RevokeSysAdmin=Revoke SysAdmin
RoleAccessFileGenerated=Role Access File Generated Successfully.
Setup=Setup
ShowReasonDialog=Show Reason Dialog for SysAdmin
StartDate=Start Date :
Submit=Submit
SysAdmin=System Administrator
SysAdminAssigned=Assigned SYSADMIN role to %1
SysAdminAssignReport=SysAdmin Assignment Report
SysAdminNotAssigned=SYSADMIN role not assigned to %1
SysAdminReport=SysAdmin Report
SysAdminRevoked=Removed SYSADMIN role from %1
User=User
UserDisableReport=Disabled Users Report
