Action=Åtgärd
AddRevokeSysAdmin=Tilldela / återkalla SysAdmin
ADMConfig=D365FO Admin Toolkit-konfiguration
ADMExportRoleAccess=D365FO Admin Toolkit Exportera rollåtkomst
ADMMaintain=D365FO Admin Toolkit Underhåll
ADMSysAdmAssignment=D365FO Admin Toolkit SysAdmin-tilldelning
ADMView=D365FO Admin Toolkit Visa
ADMViewReport=D365FO Admin Toolkit Visa SysAdmin-rapport
Assigned=Tilldelad
AssignmentReason=Tilldelningsorsak
AssingSysAdmin=Tilldela SysAdmin
ASTSysAdminChange=Admin Security Toolkit - SysAdmin-ändring
Cancel=Avbryt
ChangeReason=SysAdmin-tilldelning Ändra orsak:
ConfigurationSetup=Konfigurationsinställning
D365FOAdminToolkit=D365FO Admin Toolkit
DateTime=Datum Tid
DefaultNumDaysReport=Standardantal dagar för rapporter
EmptyReason=Värde för orsak måste anges.
EndDate=Slutdatum:
EnvConfigFileGenerated=Konfigurationsfil för miljö genererades framgångsrikt.
Environment=Miljö
ExportRoleAccess=Exportera rollåtkomst
ExportSysConfig=Exportera systemkonfiguration
InquiriesReports=Förfrågningar och rapporter
LastLogin=Senaste inloggning
ModifiedBy=Ändrad av
Reason=Orsak
Revoked=Återkallad
RevokeSysAdmin=Återkalla SysAdmin
RoleAccessFileGenerated=Rollåtkomstfil genererades framgångsrikt.
Setup=Inställning
ShowReasonDialog=Visa orsaksdialog för SysAdmin
StartDate=Startdatum:
Submit=Skicka
SysAdmin=Systemadministratör
SysAdminAssigned=Tilldelade SYSADMIN-rollen till %1
SysAdminAssignReport=SysAdmin-tilldelningsrapport
SysAdminNotAssigned=SYSADMIN-rollen inte tilldelad till %1
SysAdminReport=SysAdmin-rapport
SysAdminRevoked=Tog bort SYSADMIN-rollen från %1
User=Användare